NO assets/corridor.xpm
SO assets/neon.xpm
EA assets/texice.xpm
WE assets/texmagma.xpm

F 66,29,103
C 106,116,178
C 106,116,178


        1111111111111111111111111
        1000000000110000000000001
        1011000001110000000000001
        1001000000000000000000001
111111111011000001110000000000001
100000000011000001111101111111111
11110111111111011100000010001
11110111111111011101010000001
11000000110101011100000000001
10000000000000001100000000001
10000000000000001101010000001
110000011101101111010100N0111
11110111 1110101 101111000001
11111111 1111111 111111111111