NO assets/corridor.xpm
SO assets/neon.xpm
WE assets/neon.xpm
EA assets/corridor.xpm
D assets/door2.xpm


F 66,29,103
C 106,116,178


        1111111111111111111111111
        1000000000110000000000001
        1011000001110000000000001
        1001000000000000000000001
111111111011000001110000000000001
100000000011000001110111111111111
11110111111111011100000010001
11110111111111011101010000001
11000000110101011100000000X01
10000000000000001100000000001
10000000000000001101X10000001
110000011101X1011111X10000N0111
11110111 1110101 101111000001
11111111 1111111 111111111111