NO assets/corridor.xpm
SO assets/corridor.xpm
EA assets/corridor.xpm
WE assets/corridor.xpm
D assets/door2.xpm

F 66,29,103
C 106,116,0


        1111111111111111111111111
        1000000000110000000000001
        1011000001110000000000001
        10010000000D00000X0000001
11111111101100X001110000000000001
1000000000110000011111D1111111111
11110111111111D11100000010001
11110111111111011101010000001
11000000110101011100000000001
1000000000000000011000000X001
100000000X0000000D00010000001
110000011101101111010100N0111
11110111 1110101 101111000001
11111111 1111111 111111111111